9 10 16 4 8
3 0 0 0 1 0 -1
0 0 0 1 0 0 0
3 0 0 1 1 0 -1
3 0 0 1 1 0 -1
3 0 0 0 1 0 -1
3 0 0 0 1 0 -1
3 0 0 0 1 0 -1
3 0 0 0 1 0 -1
3 0 0 0 1 0 -1
0 0 0 1 0 0 1
3 0 0 1 1 0 -1
0 0 0 1 0 0 5
0 0 0 1 0 0 6
0 0 0 1 0 0 7
3 0 0 0 1 0 -1
3 0 0 0 1 0 -1
3 0 0 0 1 0 -1
0 0 0 1 0 0 2
0 0 0 1 0 0 3
0 0 0 1 0 0 4
3 0 0 0 1 1 -1
0 0 0 1 0 0 8
3 0 0 1 1 0 -1
3 0 0 1 1 0 -1
3 0 0 0 1 0 -1
3 0 0 0 1 0 -1
3 0 0 1 1 0 -1
3 0 0 1 1 0 -1
3 0 0 0 1 1 -1
3 0 1 0 1 0 -1
3 0 0 1 1 0 -1
3 0 0 1 1 0 -1
