207 5 8 8 16
0 0 0 0 191 0 1 0
0 0 0 0 192 0 1 0
14 0 0 1 12 0 0 0
14 0 0 1 13 0 0 0
0 0 0 0 56 1 0 0
0 0 0 0 55 1 0 0
0 0 0 0 54 1 0 0
0 0 0 0 180 0 1 0
0 0 0 0 179 0 1 0
0 0 0 0 178 0 1 0
0 0 0 0 177 0 1 0
0 0 0 0 176 0 1 0
0 0 0 0 175 0 1 0
0 0 0 0 174 0 1 0
0 0 0 0 173 0 1 0
0 0 0 0 172 0 1 0
0 0 0 0 190 0 1 0
0 0 0 0 193 0 1 0
14 0 0 1 15 0 0 0
14 0 0 1 14 0 0 0
0 0 0 0 57 1 0 0
0 0 0 0 58 1 0 0
0 0 0 0 59 1 0 0
0 0 0 0 181 0 1 0
0 0 0 0 182 0 1 0
0 0 0 0 183 0 1 0
0 0 0 0 184 0 1 0
0 0 0 0 185 0 1 0
0 0 0 0 186 0 1 0
0 0 0 0 187 0 1 0
0 0 0 0 188 0 1 0
0 0 0 0 189 0 1 0
0 0 0 0 195 0 1 0
0 0 0 0 194 0 1 0
14 0 0 1 16 0 0 0
14 0 0 1 17 0 0 0
0 0 0 0 82 1 0 0
0 0 0 0 81 1 0 0
0 0 0 0 152 0 0 1
0 0 0 0 151 0 0 1
0 0 0 0 150 0 0 1
0 0 0 0 149 0 0 1
0 0 0 0 148 0 0 1
0 0 0 0 147 0 0 1
0 0 0 0 146 0 0 1
0 0 0 0 145 0 0 1
0 0 0 0 144 0 0 1
0 0 0 0 143 0 0 1
0 0 0 0 196 0 1 0
0 0 0 0 134 1 0 0
14 0 0 1 19 0 0 0
14 0 0 1 18 0 0 0
0 0 0 0 83 1 0 0
0 0 0 0 84 1 0 0
0 0 0 0 85 1 0 0
0 0 0 0 200 0 1 0
0 0 0 0 199 0 1 0
0 0 0 0 88 1 0 0
0 0 0 0 89 1 0 0
0 0 0 0 90 1 0 0
0 0 0 0 91 1 0 0
0 0 0 0 92 1 0 0
0 0 0 0 171 0 1 0
0 0 0 0 166 0 1 0
0 0 0 0 197 0 1 0
6 0 1 0 203 0 0 0
14 0 0 1 20 0 0 0
14 0 0 1 21 0 0 0
14 0 0 1 27 0 0 0
14 0 0 1 26 0 0 0
14 0 0 1 31 0 0 0
14 0 0 1 30 0 0 0
14 0 0 1 35 0 0 0
14 0 0 1 34 0 0 0
14 0 0 1 40 0 0 0
14 0 0 1 39 0 0 0
14 0 0 1 44 0 0 0
14 0 0 1 43 0 0 0
2 1 0 0 206 0 0 0
0 0 0 0 167 0 1 0
0 0 0 0 198 0 1 0
0 0 0 0 131 1 0 0
14 0 0 1 23 0 0 0
14 0 0 1 22 0 0 0
14 0 0 1 24 0 0 0
14 0 0 1 25 0 0 0
14 0 0 1 28 0 0 0
14 0 0 1 29 0 0 0
14 0 0 1 32 0 0 0
14 0 0 1 36 0 0 0
14 0 0 1 37 0 0 0
14 0 0 1 38 0 0 0
14 0 0 1 41 0 0 0
14 0 0 1 42 0 0 0
2 1 0 0 205 0 0 0
0 0 0 0 168 0 1 0
0 0 0 0 129 1 0 0
0 0 0 0 125 1 0 0
6 0 1 0 204 0 0 0
0 0 0 0 202 0 1 0
0 0 0 0 201 0 1 0
0 0 0 0 117 1 0 0
0 0 0 0 116 1 0 0
0 0 0 0 113 1 0 0
0 0 0 0 112 1 0 0
0 0 0 0 109 1 0 0
0 0 0 0 108 1 0 0
0 0 0 0 105 1 0 0
0 0 0 0 104 1 0 0
0 0 0 0 102 1 0 0
0 0 0 0 169 0 1 0
0 0 0 0 170 0 1 0
0 0 0 0 127 1 0 0
0 0 0 0 153 0 0 1
0 0 0 0 154 0 0 1
0 0 0 0 155 0 0 1
0 0 0 0 156 0 0 1
0 0 0 0 157 0 0 1
0 0 0 0 158 0 0 1
0 0 0 0 159 0 0 1
0 0 0 0 160 0 0 1
0 0 0 0 161 0 0 1
0 0 0 0 162 0 0 1
0 0 0 0 106 1 0 0
0 0 0 0 103 1 0 0
0 0 0 0 163 0 1 0
0 0 0 0 164 0 1 0
0 0 0 0 165 0 1 0
